컬럼영문명	컬럼명
ldadng_ymd	적재_년월일
ldadng_sn	적재_일련번호
srl	시리얼_순번
brd_deal_dt	승차_거래_일자
card_brd_tm	카드_승차_시간
trff_mthd_cd	교통_수단_코드
trsf_cnt	환승_횟수
trff_bsns_cd	교통_사업자_코드
card_car_cd	카드_차량_코드
user_dvs_cd	사용자_구분_코드
svc_strt_tm	운행_출발_시간
card_svc_tm	카드_운행_시간
card_brd_sttn_id	카드_승차_정류장_ID
card_alit_sttn_id	카드_하차_정류장_ID
alit_deal_dt	하차_거래_일자
alit_deal_tm	하차_거래_시간
user_cnt	이용자_수
brd_amt	승차_금액
alit_amt	하차_금액
brd_cmpy_dt	승차_정산_일자
alit_cmpy_dt	하차_정산_일자
card_rout_cd	카드_노선_코드
